Establishing	VERB
Models	LEMMA
in	NONE
Industrial	DICT
Innovation	VERB

After	IDENTITY
its	NONE
competitor	DICT
invented	VERB
the	NONE
front	IDENTITY
loading	VERB
washing	VERB
machine	IDENTITY
,	NONE
the	NONE
CEO	DISJOINT
of	NONE
the	NONE
American	DICT
IM	DISJOINT
company	NONE
believed	VERB
that	NONE
each	IDENTITY
of	NONE
its	NONE
employees	DISJOINT
had	NONE
the	NONE
ability	VERB
for	NONE
innovation	VERB
,	NONE
and	IDENTITY
formulated	VERB
strategic	DICT
countermeasures	LEMMA
for	NONE
innovation	VERB
in	NONE
the	NONE
industry	IDENTITY
.	NONE

1	IDENTITY
.	NONE
Establish	VERB
an	NONE
innovation	VERB
fund	IDENTITY
with	NONE
a	NONE
maximum	IDENTITY
amount	VERB
of	NONE
1,000	COREF
U.S.	DICT
dollars	DICT
.	NONE

